007002014
240701050
105004206
600510800
010000060
004086009
702300401
060109085
890400600