004050000
900734600
003021049
035090480
076010920
310970200
009182003
000060100