080600010
000008256
001000000
000904603
009070500
407502000
000000800
713400000
050009030