000600000
000000501
369080400
000006800
000130009
405009000
000000300
006007000
100340000